Xu, Xu, Xu, Xu, Xu, Xu, Xu, Xu, Xu, Xu, Xu, Xu, Xu, Xu, Xu, Xu, Xu, Xu, Xu, Xu, Xu, Xu, Xu, Xu, Xu, Xu, Xu, Xu, Xu, Xu, Xu, Xu, Xu, Xu, Xu, Xu, Xu, Xu, Xu, Xu, Xu, Gg, Gg, Gg, Gg, Gg
Xu, Xu, Xu, Xu, Xu, Xu, Xu, Xu, Xu, Xu, Xu, Xu, Xu, Xu, Xu, Xu, Xu, Xu, Xu, Xu, Xu, Xu, Xu, Xu, Xu, Xu, Xu, Xu, Xu, Xu, Xu, Xu, Xu, Xu, Xu, Xu, Xu, Xu, Xu, Xu, Xu, Uue, Uue, Gg, Gg, Gg
Xu, Xu, Xu, Xu, Xu, Xu, Xu, Xu, Xu, Xu, Xu, Xu, Xu, Xu, Xu, Xu, Xu, Xu, Xu, Xu, Xu, Xu, Xu, Xu, Xu, Xu, Xu, Xu, Xu, Xu, Xu, Xu, Xu, Xu, Xu, Xu, Xu, Xu, Xu, Xu, Uue, Uue, Uue, Uue, Uue, Gg
Xu, Xu, Xu, Xu, Xu, Xu, Xu, Xu, Xu, Xu, Xu, Xu, Xu, Xu, Xu, Xu, Xu, Xu, Xu, Xu, Xu, Xu, Xu, Xu, Xu, Xu, Xu, Xu, Xu, Xu, Xu, Xu, Xu, Uue, Xu, Xu, Xu, Xu, Xu, Xu, Wwf, Uue, Xu, Uue, Xu, Xu
Xu, Xu, Xu, Xu, Uue, Uue, Uue, Xu, Xu, Xu, Xu, Xu, Xu, Xu, Xu, Xu, Xu, Xu, Xu, Xu, Xu, Xu, Xu, Xu, Xu, Xu, Xu, Xu, Xu, Xu, Xu, Xu, Xu, Uue, Wwf, Xu, Xu, Xu, Xu, Uue, Uue, Xu, Xu, Xu, Xu, Xu
Xu, Xu, Xu, Uue, Ur, Ur, Ur, Uue, Xu, Xu, Xu, Xu, Xu, Xu, Xu, Xu, Xu, Xu, Xu, Xu, Xu, Xu, Xu, Xu, Xu, Xu, Xu, Xu, Xu, Xu, Xu, Xu, Xu, Uue, Uue, Xu, Xu, Xu, Xu, Xu, Uue, Xu, Xu, Xu, Xu, Xu
Xu, Xu, Xu, Uue, Ur, Qxu, Ur, Uue, Xu, Xu, Xu, Xu, Xu, Xu, Xu, Xu, Xu, Xu, Xu, Xu, Xu, Xu, Xu, Xu, Xu, Xu, Xu, Xu, Xu, Xu, Xu, Xu, Xu, Xu, Uue, Uue, Xu, Xu, Xu, Xu, Uu^Vu, Uue, Uue, Xu, Xu, Xu
Xu, Xu, Xu, Uue, Uue, Ur, Uue, Uue, Xu, Xu, Xu, Xu, Xu, Xu, Xu, Xu, Xu, Xu, Xu, Xu, Xu, Xu, Xu, Xu, Xu, Xu, Xu, Xu, Xu, Xu, Xu, Xu, Xu, Xu, Xu, Uue, Wwf, Xu, Xu, Xu, Xu, Xu, Uue, Xu, Xu, Xu
Xu, Xu, Xu, Uue, Uue, Uue, Xu, Xu, Xu, Xu, Xu, Xu, Xu, Xu, Xu, Xu, Xu, Xu, Xu, Xu, Xu, Xu, Xu, Xu, Xu, Xu, Xu, Xu, Xu, Xu, Xu, Xu, Xu, Xu, Xu, Xu, Uue, Xu, Xu, Xu, Xu, Xu, Uue, Xu, Xu, Xu
Xu, Xu, Xu, Xu, Xu, Uue, Uue, Xu, Uu^Vu, Xu, Xu, Xu, Xu, Xu, Uue, Xu, Uue, Xu, Xu, Xu, Xu, Xu, Xu, Xu, Xu, Xu, Xu, Xu, Xu, Xu, Xu, Xu, Xu, Xu, Xu, Xu, Xu, Uue, Uue, Xu, Wwf, Uue, Xu, Xu, Xu, Xu
Xu, Xu, Xu, Xu, Xu, Xu, Xu, Wwf, Wwf, Xu, Xu, Xu, Uue, Uue, Xu, Uue, Xu, Uue, Uue, Xu, Xu, Xu, Xu, Xu, Xu, Xu, Xu, Xu, Xu, Xu, Xu, Xu, Xu, Xu, Xu, Xu, Xu, Xu, Xu, Uue, Uue, Xu, Xu, Xu, Xu, Xu
Xu, Xu, Xu, Xu, Xu, Xu, Xu, Wwf, Wwf, Xu, Xu, Uue, Xu, Xu, Xu, Xu, Xu, Xu, Uue, Xu, Xu, Xu, Xu, Xu, Xu, Xu, Xu, Xu, Xu, Xu, Xu, Xu, Xu, Xu, Xu, Xu, Xu, Xu, Xu, Xu, Uue, Xu, Xu, Xu, Xu, Xu
Xu, Xu, Xu, Xu, Xu, Xu, Xu, Xu, Xu, Uue, Uue, Uue, Xu, Xu, Uue, Uue, Xu, Xu, Uue, Wwf, Uue, Uu^Vu, Xu, Xu, Xu, Xu, Xu, Xu, Xu, Xu, Xu, Xu, Xu, Xu, Xu, Xu, Xu, Xu, Xu, Xu, Xu, Uue, Xu, Xu, Xu, Xu
Xu, Xu, Xu, Xu, Xu, Xu, Xu, Xu, Xu, Xu, Xu, Wwf, Xu, Xu, Uue, Xu, Xu, Xu, Uue, Wwf, Xu, Uue, Uue, Xu, Xu, Xu, Xu, Xu, Xu, Xu, Xu, Xu, Xu, Xu, Xu, Xu, Xu, Xu, Xu, Xu, Xu, Uue, Xu, Xu, Xu, Xu
Xu, Xu, Xu, Xu, Xu, Xu, Xu, Xu, Xu, Xu, Xu, Uue, Uue, Xu, Uue, Xu, Uue, Uue, Xu, Xu, Xu, Uue, Uue, Uue, Uue, Uue, Uue, Xu, Xu, Xu, Xu, Xu, Xu, Xu, Xu, Xu, Uu^Vu, Uue, Uue, Uue, Uue, Uue, Uue, Uue, Uue, Xu
Xu, Xu, Xu, Xu, Xu, Xu, Xu, Xu, Xu, Xu, Uu^Vu, Uue, Uue, Xu, Xu, Wwf, Xu, Xu, Xu, Xu, Xu, Xu, Xu, Uue, Xu, Uue, Uue, Uue, Uue, Xu, Xu, Xu, Xu, Xu, Xu, Xu, Xu, Uue, Uue, Wwf, Uue, Uue, Uue, Uue, Uue, Xu
Xu, Xu, Xu, Xu, Xu, Xu, Xu, Xu, Xu, Xu, Xu, Xu, Xu, Uue, Xu, Xu, Xu, Xu, Xu, Xu, Xu, Xu, Xu, Xu, Xu, Xu, Xu, Uue, Uue, Xu, Xu, Xu, Xu, Xu, Xu, Xu, Xu, Uue, Uue, Uue, Wwf, Uue, Uue, Wwf, Uue, Xu
Xu, Xu, Xu, Uue, Uue, Uue, Uue, Xu, Xu, Xu, Xu, Xu, Uue, Uue, Uue, Xu, Xu, Xu, Xu, Xu, Xu, Xu, Xu, Xu, Xu, Xu, Xu, Xu, Xu, Uue, Uue, Xu, Xu, Xu, Uue, Uue, Uue, Uue, Uue, Uue, Uue, Uue, Uue, Uue, Uue, Xu
Xu, Xu, Xu, Uue, Uue,2 Uue, Uue, Xu, Xu, Xu, Uue, Wwf, Xu, Xu, Xu, Uue, Uue, Xu, Xu, Xu, Xu, Xu, Xu, Xu, Xu, Xu, Xu, Xu, Xu, Xu, Uue, Xu, Uue, Uue, Xu, Uue, Xu, Uue, Wwf, Uue, Uue, Uue, Uue, Uue, Uue, Xu
Xu, Xu, Xu, Uue, Uue, Uue, Uue, Uue, Xu, Xu, Uue, Uue, Xu, Xu, Xu, Uue, Uue, Xu, Xu, Xu, Uue, Xu, Wwf, Xu, Xu, Xu, Xu, Xu, Xu, Xu, Xu, Uue, Uue, Xu, Xu, Xu, Xu, Uue, Wwf, Uue, Uue, Uue, Wwf, Uue, Uue, Xu
Xu, Xu, Xu, Uue, Uue, Uue, Uue, Uue, Xu, Uue, Uue, Uue, Xu, Xu, Xu, Xu, Xu, Uue, Uue, Uue, Xu, Uue, Xu, Xu, Xu, Xu, Xu, Xu, Xu, Xu, Xu, Xu, Uue, Uue, Xu, Xu, Xu, Uue, Uue, Uue, Uue, Uue, Uue, Uue, Uue, Xu
Xu, Xu, Xu, Uue, Xu, Xu, Xu, Xu, Uue, Wwf, Uue, Xu, Xu, Xu, Xu, Xu, Xu, Uue, Uue, Uue, Uu^Vu, Xu, Xu, Xu, Uue, Xu, Xu, Xu, Xu, Xu, Xu, Uu^Vu, Uue, Wwf, Xu, Xu, Xu, Uue, Uue, Uue, Uue, Uue, Uue, Uue, Uue, Xu
Xu, Xu, Xu, Uue, Uue, Uue, Uue, Uue, Uue, Uue, Xu, Xu, Xu, Xu, Xu, Xu, Xu, Uue, Xu, Xu, Xu, Xu, Xu, Xu, Xu, Uue, Uue, Xu, Xu, Xu, Xu, Xu, Uue, Wwf, Xu, Xu, Xu, Xu, Uu^Vu, Xu, Xu, Xu, Xu, Uu^Vu, Xu, Xu
Xu, Xu, Xu, Xu, Xu, Xu, Xu, Xu, Xu, Xu, Xu, Xu, Xu, Xu, Xu, Xu, Uue, Uue, Xu, Xu, Xu, Xu, Xu, Xu, Xu, Xu, Xu, Uue, Wwf, Xu, Xu, Xu, Uue, Uue, Xu, Xu, Xu, Xu, Xu, Xu, Xu, Xu, Xu, Xu, Xu, Xu
Xu, Xu, Xu, Xu, Xu, Xu, Xu, Xu, Xu, Xu, Xu, Xu, Xu, Xu, Uue, Uue, Uue, Uue, Xu, Xu, Xu, Xu, Xu, Xu, Xu, Xu, Xu, Uue, Xu, Uue, Uue, Uue, Uue, Xu, Xu, Xu, Xu, Xu, Xu, Xu, Xu, Xu, Xu, Xu, Xu, Xu
Xu, Xu, Uue, Xu, Uue, Xu, Uue, Xu, Xu, Xu, Xu, Uu^Vu, Uue, Uue, Xu, Uue, Xu, Wwf, Uue, Xu, Xu, Xu, Xu, Xu, Xu, Xu, Xu, Xu, Xu, Xu, Xu, Xu, Wwf, Xu, Xu, Xu, Xu, Xu, Xu, Xu, Xu, Xu, Xu, Xu, Xu, Xu
Xu, Xu, Wwf, Uue, Xu, Uue, Xu, Uue, Uue, Xu, Xu, Xu, Uue, Xu, Xu, Xu, Xu, Xu, Wwf, Xu, Wwf, Xu, Xu, Xu, Xu, Xu, Xu, Xu, Xu, Xu, Xu, Uue, Uue, Xu, Xu, Xu, Xu, Xu, Xu, Xu, Xu, Xu, Xu, Xu, Xu, Xu
Xu, Wwf, Uue, Xu, Xu, Xu, Uue, Xu, Uue, Xu, Uue, Wwf, Uue, Xu, Xu, Xu, Xu, Xu, Xu, Uue, Uue, Wwf, Xu, Xu, Xu, Xu, Uue, Xu, Xu, Xu, Xu, Uue, Uue, Uu^Vu, Xu, Xu, Xu, Xu, Xu, Xu, Xu, Xu, Xu, Xu, Xu, Xu
Xu, Uue, Uue, Xu, Uue, Uue, Xu, Xu, Xu, Uue, Uue, Uue, Xu, Xu, Xu, Xu, Xu, Xu, Xu, Xu, Xu, Uue, Uue, Xu, Wwf, Uue, Xu, Uue, Uue, Xu, Xu, Xu, Wwf, Xu, Uue, Xu, Xu, Xu, Xu, Xu, Xu, Xu, Xu, Xu, Xu, Xu
Xu, Xu, Xu, Uue, Xu, Uue, Xu, Xu, Xu, Uue, Xu, Xu, Xu, Xu, Xu, Xu, Xu, Xu, Xu, Xu, Xu, Uue, Uue, Uue, Xu, Xu, Xu, Xu, Wwf, Xu, Uue, Wwf, Wwf, Uue, Wwf, Uue, Xu, Xu, Xu, Xu, Xu, Xu, Xu, Xu, Xu, Xu
Xu, Xu, Xu, Xu, Xu, Xu, Uu^Vu, Xu, Uue, Uue, Uue, Xu, Xu, Xu, Xu, Xu, Xu, Xu, Xu, Xu, Xu, Xu, Xu, Xu, Xu, Xu, Xu, Xu, Uue, Xu, Xu, Uue, Uue, Uue, Uue, Uue, Xu, Xu, Xu, Xu, Xu, Xu, Xu, Xu, Xu, Xu
Xu, Xu, Xu, Xu, Xu, Xu, Wwf, Wwf, Rr, Xu, Xu, Xu, Xu, Xu, Xu, Xu, Xu, Xu, Xu, Xu, Xu, Xu, Xu, Xu, Xu, Xu, Wwf, Uue, Xu, Xu, Xu, Xu, Uue, Xu, Xu, Xu, Xu, Xu, Xu, Xu, Xu, Xu, Xu, Xu, Xu, Xu
Xu, Xu, Wwf, Xu, Uue, Uue, Wwf, Rr,1 Rr, Rr, Xu, Xu, Xu, Xu, Xu, Xu, Xu, Xu, Xu, Xu, Xu, Xu, Xu, Xu, Xu, Uue, Uue, Xu, Uue, Xu, Uue, Uue, Xu, Xu, Xu, Xu, Xu, Xu, Xu, Xu, Xu, Xu, Xu, Xu, Xu, Xu
Uue, Uue, Uue, Uue, Wwf, Uue, Xu, Rr, Rr, Rr, Xu, Xu, Xu, Xu, Xu, Xu, Xu, Xu, Xu, Xu, Xu, Xu, Xu, Xu, Xu, Uue, Xu, Uue, Xu, Uue, Xu, Xu, Xu, Xu, Xu, Xu, Xu, Xu, Xu, Xu, Xu, Xu, Xu, Xu, Xu, Xu
Uue, Uue, Uue, Uue, Xu, Xu, Xu, Xu, Xu, Xu, Xu, Xu, Xu, Xu, Xu, Xu, Xu, Xu, Xu, Xu, Xu, Xu, Xu, Xu, Xu, Xu, Xu, Xu, Xu, Xu, Xu, Xu, Xu, Xu, Xu, Xu, Xu, Xu, Xu, Xu, Xu, Xu, Xu, Xu, Xu, Xu
