Xue, Xue, Xue, Xue, Xue, Xue, Xue, Xue, Gg, Gg, Xue, Xue, Xue, Xue, Xue, Xue, Xue, Xue, Xue, Xue, Xue, Xue, Xue, Xue, Xue, Xue, Xue, Xue, Xue, Xue, Xue, Xue, Xue, Xue, Xue, Xue, Xue, Xue, Xue, Xue, Xue, Xue, Xue, Xue, Xue, Xue, Xue, Xue, Xue, Xue, Xue, Xue, Xue, Xue, Xue, Xue, Xue, Xue, Xue, Xue, Xue, Xue, Xue
Xue, Xue, Xue, Xue, Xue, Xue, Xue, Xue, Xue, Gg, Gg, Xue, Xue, Xue, Xue, Xue, Xue, Xue, Xue, Xue, Xue, Xue, Xue, Xue, Xue, Xue, Xue, Xue, Xue, Xue, Xue, Xue, Xue, Xue, Xue, Xue, Xue, Xue, Xue, Xue, Xue, Xue, Xue, Xue, Xue, Xue, Xue, Xue, Xue, Xue, Xue, Xue, Xue, Xue, Xue, Xue, Xue, Xue, Xue, Xue, Xue, Xue, Xue
Xue, Xue, Xue, Xue, Xue, Xue, Xue, Xue, Xue, Gg, Gg, Xue, Xue, Xue, Xue, Xue, Xue, Xue, Xue, Xue, Xue, Xue, Xue, Xue, Xue, Xue, Xue, Xue, Xue, Xue, Xue, Xue, Xue, Xue, Xue, Xue, Xue, Xue, Xue, Xue, Xue, Xue, Xue, Xue, Xue, Xue, Xue, Xue, Xue, Xue, Xue, Xue, Xue, Xue, Xue, Xue, Xue, Xue, Xue, Xue, Xue, Xue, Xue
Xue, Xue, Xue, Xue, Xue, Xue, Xue, Xue, Xue, Xue, Gg, Gg, Xue, Xue, Xue, Xue, Xue, Xue, Xue, Xue, Xue, Xue, Xue, Xue, Xue, Xue, Xue, Xue, Xue, Xue, Xue, Xue, Xue, Xue, Xue, Xue, Xue, Xue, Xue, Xue, Xue, Xue, Xue, Xue, Xue, Xue, Xue, Xue, Xue, Xue, Xue, Xue, Xue, Xue, Xue, Xue, Xue, Xue, Xue, Xue, Xue, Xue, Xue
Xue, Xue, Xue, Xue, Xue, Xue, Xue, Xue, Xue, Xue, Gg, Gg, Gg, Xue, Xue, Xue, Xue, Xue, Xue, Xue, Xue, Xue, Xue, Xue, Xue, Xue, Gg, Gg, Gg, Rb, Rb, Xue, Xue, Xue, Xue, Xue, Xue, Xue, Xue, Xue, Xue, Xue, Xue, Xue, Xue, Xue, Xue, Xue, Ww, Xue, Wog, Xue, Xue, Xue, Xue, Xue, Xue, Xue, Xue, Xue, Xue, Xue, Xue
Xue, Xue, Xue, Xue, Xue, Xue, Xue, Xue, Xue, Xue, Xue, Gg, Gg, Xue, Xue, Xue, Xue, Xue, Xue, Xue, Xue, Xue, Xue, Xue, Rb, Wwf, Gg, Gg, Gg, Rb, Rb, Rb, Wwf, Xue, Xue, Xue, Xue, Xue, Xue, Xue, Xue, Xue, Xue, Xue, Xue, Xue, Gg, Ww, Ww, Ww, Wog, Wog, Wog, Wog, Xue, Xue, Xue, Xue, Xue, Xue, Xue, Xue, Xue
Xue, Xue, Xue, Xue, Xue, Xue, Xue, Xue, Xue, Xue, Xue, Gg, Gg, Gg, Gg, Xue, Xue, Xue, Xue, Xue, Xue, Xue, Rb, Rb, Rb, Wwf, Gg, Gg, Re^Vct, Rb, Wwf, Wwf, Gg, Gg, Gg, Xue, Xue, Xue, Xue, Xue, Xue, Xue, Xue, Xue, Xue, Gg, Gg, Gg, Gg, Ww, Ww, Wog, Wog, Wog, Wog, Xue, Xue, Xue, Xue, Xue, Xue, Xue, Xue
Xue, Xue, Xue, Xue, Xue, Xue, Xue, Xue, Xue, Xue, Xue, Xue, Gg, Gg, Gg, Gg, Gg, Xue, Wwf, Xue, Gg, Gg, Gg, Rb, Rb, Wwf, Gg, Gg, Gg, Rb, Wwf, Gg, Gg, Gg, Gg, Gg, Gg, Xue, Xue, Xue, Xue, Xue, Xue, Xue, Xue, Gg, Gg, Gg, Gg, Gg, Gg, Ww, Ww, Wog, Ww, Xue, Xue, Xue, Xue, Xue, Xue, Xue, Xue
Xue, Xue, Xue, Xue, Xue, Xue, Xue, Xue, Xue, Xue, Xue, Xue, Gg, Gg, Gg, Gg, Gg, Gg, Wwf, Gg, Gg, Gg, Gg, Rb, Wwf, Wwf, Wwf, Gg, Wwf, Wwf, Gg, Gg, Gg, Gg, Gg, Gg, Gg, Gg, Gg, Xue, Xue, Xue, Xue, Xue, Xue, Xue, Xue, Gg, Gg, Gg, Gg, Gg, Gg, Ww, Gg, Xue, Xue, Xue, Xue, Xue, Xue, Xue, Xue
Xue, Xue, Xue, Xue, Xue, Xue, Xue, Xue, Xue, Xue, Xue, Xue, Gg, Gg, Gg, Re^Vct, Gg, Gg, Wwf, Gg, Gg, Gg, Wwf, Wwf, Gg, Gg, Gg, Wwf, Wwf, Gg, Gg, Gg, Gg, Gg, Wwf, Gg, Gg, Gg, Gg, Gg, Gg, Xue, Xue, Xue, Xue, Xue, Xue, Xue, Gg, Gg, Gg, Gg, Gg, Gg, Xue, Xue, Xue, Xue, Xue, Xue, Xue, Xue, Xue
Xue, Xue, Xue, Xue, Xue, Xue, Xue, Xue, Xue, Xue, Xue, Gg, Gg, Gg, Gg, Gg, Gg, Gg, Wwf, Gg, Wwf, Wwf, Gg,2 Gg, Gg, Gg, Gg, Gg, Gg, Wwf, Wwf, Gg, Gg, Gg, Rb, Wwf, Wwf, Gg, Gg, Wwf, Gg, Xue, Xue, Xue, Xue, Xue, Xue, Xue, Gg, Gg, Gg, Gg, Gg, Gg, Xue, Xue, Xue, Xue, Xue, Xue, Xue, Xue, Xue
Xue, Xue, Xue, Xue, Xue, Xue, Xue, Xue, Xue, Xue, Xue, Gg, Wwf, Gg, Gg, Gg, Gg, Gg, Wwf, Wwf, Gg, Gg, Gg, Gg, Gg, Gg, Gg, Gg, Gg, Gg, Wwf, Wwf, Gg, Rb, Rb, Rb, Wwf, Gg, Gg, Wwf, Gg, Gg, Gg, Xue, Gg, Xue, Gg, Gg, Gg, Gg, Gg, Gg, Xue, Xue, Xue, Xue, Xue, Xue, Xue, Xue, Xue, Xue, Xue
Xue, Xue, Xue, Xue, Xue, Xue, Xue, Xue, Xue, Xue, Gg, Gg, Gg, Wwf, Wwf, Wwf, Wwf, Wwf, Wwf, Gg, Gg, Gg, Gg, Gg, Gg, Gg, Gg, Gg, Wwf, Wwf, Wwf, Gg, Gg, Rb, Rb, Rb, Gg, Wwf, Wwf, Wwf, Gg, Gg, Gg, Gg, Gg, Gg, Gg, Gg, Gg, Gg, Xue, Xue, Xue, Xue, Xue, Xue, Xue, Xue, Xue, Xue, Xue, Xue, Xue
Xue, Xue, Xue, Xue, Xue, Xue, Xue, Xue, Xue, Xue, Gg, Gg, Gg, Gg, Gg, Wwf, Rb, Rb, Rb, Wwf, Wwf, Gg, Gg, Gg, Gg, Gg, Wwf, Wwf, Gg, Gg, Gg, Wwf, Wwf, Gg, Gg, Gg, Gg, Gg, Wwf, Gg, Rb, Rb, Re^Vct, Gg, Gg, Gg, Wwf, Gg, Gg, Xue, Xue, Xue, Xue, Xue, Xue, Xue, Xue, Xue, Xue, Xue, Xue, Xue, Xue
Xue, Xue, Xue, Xue, Xue, Xue, Xue, Xue, Xue, Gg, Gg, Gg, Gg, Gg, Rb, Rb, Rb, Rb, Rb, Rb, Gg, Wwf, Wwf, Gg, Wwf, Wwf, Wwf, Gg, Gg, Gg, Gg, Gg, Rb, Wwf, Wwf, Gg, Gg, Gg, Wwf, Rb, Rb, Rb, Rb, Gg, Wwf, Wwf, Gg, Gg, Gg, Xue, Xue, Xue, Xue, Xue, Xue, Xue, Xue, Xue, Xue, Xue, Xue, Xue, Xue
Xue, Xue, Xue, Xue, Xue, Xue, Xue, Xue, Xue, Gg, Gg, Gg, Gg, Gg, Rb, Re^Vct, Rb, Rb, Gg, Gg, Gg, Gg, Gg, Wwf, Gg, Gg, Gg, Wwf, Gg, Gg, Rb, Rb, Rb, Rb, Gg, Wwf, Gg, Gg, Wwf, Rb, Rb, Rb, Gg, Gg, Wwf, Gg, Gg, Gg, Gg, Xue, Xue, Xue, Xue, Xue, Xue, Xue, Xue, Xue, Xue, Xue, Xue, Xue, Xue
Xue, Xue, Xue, Xue, Xue, Xue, Xue, Xue, Xue, Gg, Gg, Gg, Gg, Gg, Rb, Rb, Gg, Gg, Gg, Gg, Gg, Gg, Wwf, Wwf, Gg, Gg, Gg, Wwf, Wwf, Rb, Rb, Rb, Gg, Gg, Gg, Gg, Gg, Gg, Wwf, Gg, Rb, Rb, Rb, Wwf, Gg, Gg, Gg, Gg, Gg, Gg, Gg, Xue, Xue, Xue, Xue, Xue, Xue, Xue, Xue, Xue, Xue, Xue, Xue
Xue, Xue, Xue, Xue, Xue, Xue, Xue, Xue, Gg, Gg, Gg, Gg, Rb, Rb, Gg, Gg, Gg, Gg, Gg, Gg, Wwf, Wwf, Gg, Gg, Gg, Gg, Gg, Wwf, Wwf, Gg, Gg, Gg, Gg, Gg, Re^Vct, Gg, Gg, Gg, Wwf, Gg, Gg, Rb, Wwf, Wwf, Gg, Gg, Gg, Gg, Gg, Gg, Gg, Xue, Xue, Xue, Xue, Xue, Xue, Xue, Xue, Xue, Xue, Xue, Xue
Xue, Xue, Xue, Xue, Xue, Xue, Xue, Gg, Gg, Gg, Gg, Gg, Gg, Gg, Gg, Gg, Gg, Gg, Wwf, Wwf, Gg, Gg, Gg, Gg, Gg, Gg, Wwf, Wwf, Gg, Wwf, Wwf, Gg, Gg, Gg, Gg, Gg, Wwf, Wwf, Gg, Wwf, Wwf, Gg, Wwf, Gg, Gg, Gg, Gg, Gg, Gg, Gg, Gg, Xue, Xue, Xue, Xue, Xue, Xue, Xue, Xue, Xue, Xue, Xue, Xue
Xue, Xue, Xue, Xue, Xue, Xue, Xue, Xue, Gg, Gg, Gg, Gg, Wwf, Gg, Gg, Gg, Gg, Gg, Wwf, Gg, Gg, Gg, Gg, Gg, Wwf, Wwf, Gg, Rb, Rb, Rb, Gg, Wwf, Wwf, Gg, Wwf, Wwf, Gg, Gg, Gg, Gg, Gg, Wwf, Wwf, Gg, Gg, Gg, Rb, Gg, Gg, Gg, Gg, Gg, Gg, Xue, Xue, Xue, Xue, Xue, Xue, Xue, Xue, Xue, Xue
Xue, Xue, Xue, Xue, Xue, Xue, Xue, Xue, Gg, Gg, Gg, Gg, Gg, Wwf, Wwf, Wwf, Wwf, Wwf, Rb, Gg, Gg, Gg, Gg, Wwf, Gg, Gg, Gg, Rb, Rb, Re^Vct, Rb, Rb, Wwf, Wwf, Gg, Gg, Gg, Gg, Gg, Gg, Gg, Gg, Gg, Wwf, Wwf, Gg, Rb, Rb, Rb, Gg, Gg, Gg, Gg, Xue, Xue, Xue, Xue, Xue, Xue, Xue, Xue, Xue, Xue
Xue, Xue, Xue, Xue, Xue, Xue, Xue, Xue, Xue, Gg, Gg, Gg, Gg, Gg, Gg, Gg, Rb, Rb, Rb, Gg, Gg, Gg, Wwf, Wwf, Wwf, Gg, Gg, Rb, Rb, Rb, Gg, Gg, Gg, Wwf, Wwf, Gg, Gg, Gg, Gg, Gg, Gg, Gg, Wwf, Wwf, Gg, Rb, Rb, Rb, Rb, Gg, Gg, Gg, Gg, Gg, Xue, Xue, Xue, Xue, Xue, Xue, Xue, Xue, Xue
Xue, Xue, Xue, Xue, Xue, Xue, Xue, Xue, Xue, Gg, Gg, Gg, Gg, Gg, Rb, Rb, Rb, Rb, Gg, Gg, Gg, Gg, Wwf, Gg, Wwf, Gg, Gg, Rb, Gg, Gg, Gg, Gg, Gg, Gg, Gg, Wwf, Wwf, Gg, Gg, Gg, Wwf, Wwf, Gg, Gg, Gg, Rb, Rb, Rb, Rb, Rb, Gg, Gg, Gg, Gg, Xue, Xue, Xue, Xue, Xue, Xue, Xue, Xue, Xue
Xue, Xue, Xue, Xue, Xue, Xue, Xue, Xue, Gg, Gg, Gg, Gg, Gg, Gg, Gg, Gg, Gg, Gg, Gg, Gg, Gg, Gg, Wwf, Gg, Gg, Wwf, Wwf, Rb, Gg, Gg, Gg, Gg, Gg, Gg, Gg, Gg, Wwf, Wwf, Wwf, Wwf, Gg, Gg, Gg, Gg, Gg, Gg, Rb, Rb, Rb, Rb, Gg, Gg, Gg, Gg, Gg, Xue, Xue, Xue, Xue, Xue, Xue, Xue, Xue
Xue, Xue, Xue, Xue, Xue, Xue, Xue, Xue, Gg, Gg, Gg, Gg, Gg, Gg, Gg, Gg, Gg, Gg, Gg, Gg, Wwf, Wwf, Gg, Gg, Gg, Gg, Wwf, Gg, Gg, Gg, Gg, Gg, Gg, Gg, Gg, Gg, Wwf, Re^Vct, Gg, Wwf, Wwf, Gg, Gg, Gg, Gg, Gg, Gg, Rb, Gg, Rb, Gg, Gg, Gg, Gg, Gg, Xue, Xue, Xue, Xue, Xue, Xue, Xue, Xue
Xue, Xue, Xue, Xue, Xue, Xue, Xue, Gg, Gg, Gg, Gg, Gg, Rb, Gg, Gg, Gg, Wwf, Gg, Gg, Gg, Wwf, Gg, Gg, Gg, Gg, Gg, Gg, Wwf, Wwf, Gg, Wwf, Gg, Gg, Gg, Gg, Wwf, Gg, Gg, Gg, Gg, Gg, Wwf, Wwf, Gg, Gg, Gg, Gg, Gg, Gg, Gg, Gg, Gg, Gg, Gg, Gg, Gg, Xue, Xue, Xue, Xue, Xue, Xue, Xue
Xue, Xue, Xue, Xue, Xue, Xue, Gg, Gg, Gg, Gg, Rb, Rb, Rb, Rb, Rb, Rb, Rb, Wwf, Wwf, Wwf, Gg, Gg, Gg, Gg, Wwf, Gg, Gg, Gg, Gg, Wwf, Rb, Wwf, Gg, Gg, Gg, Wwf, Gg, Gg, Gg, Gg, Gg, Gg, Wwf, Gg, Gg, Gg, Gg, Gg, Gg, Gg, Gg, Gg, Gg, Gg, Gg, Gg, Gg, Xue, Xue, Xue, Xue, Xue, Xue
Xue, Xue, Xue, Xue, Gg, Gg, Gg, Gg, Gg, Gg, Rb, Rb, Re^Vct, Rb, Rb, Rb, Rb, Rb, Gg, Gg, Gg, Gg, Gg, Gg, Gg, Wwf, Wwf, Gg, Gg, Rb, Rb, Rb, Gg, Gg, Wwf, Wwf, Gg, Gg, Gg, Gg, Gg, Gg, Wwf, Wwf, Wwf, Gg, Gg, Gg, Gg, Gg, Gg, Gg, Gg, Gg, Gg, Gg, Gg, Xue, Xue, Xue, Xue, Xue, Xue
Xue, Xue, Gg, Xue, Gg, Gg, Gg, Gg, Gg, Gg, Gg, Rb, Rb, Rb, Rb, Rb, Gg, Gg, Rb, Gg, Gg, Gg, Gg, Gg, Gg, Gg, Gg, Wwf, Wwf, Rb, Rb, Rb, Wwf, Gg, Wwf, Gg, Gg, Gg, Gg, Gg, Wwf, Wwf, Gg, Gg, Gg, Wwf, Wwf, Gg, Gg, Gg, Rb, Rb, Rb, Rb, Rb, Gg, Gg, Gg, Xue, Xue, Xue, Xue, Xue
Gg, Gg^Xo, Gg, Gg, Gg, Gg, Gg, Gg, Gg, Gg, Gg, Gg, Gg, Rb, Rb, Rb, Rb, Rb, Gg, Gg, Wot, Gg, Gg, Gg, Gg, Gg, Gg, Gg, Wwf, Wwf, Wwf, Wwf, Wwf, Wwf, Rb, Gg, Gg, Gg, Wwf, Wwf, Gg, Gg, Gg, Gg, Gg, Gg, Gg, Wwf, Wwf, Gg, Gg, Gg, Gg, Rb, Rb, Gg, Gg, Gg, Gg, Xue, Xue, Xue, Xue
Gg, Xue, Gg, Gg, Gg, Gg, Gg, Gg, Gg, Gg, Gg, Gg, Gg, Gg, Gg, Gg, Gg, Gg, Wot, Wot, Wot, Wot, Wot, Gg, Gg, Gg, Wwf, Wwf, Gg, Gg, Gg, Gg, Wwf, Wwf, Rb, Rb, Gg, Gg, Gg, Wwf, Wwf, Gg, Gg, Gg, Gg, Gg, Wwf, Wwf, Gg, Wwf, Wwf, Gg, Wwf, Gg, Gg, Re^Vct, Gg, Gg, Gg, Gg, Xue, Xue, Xue
Gg, Gg^Xo, Gg, Gg, Gg, Gg, Gg, Gg, Gg, Gg, Gg, Gg, Gg, Gg, Gg, Gg, Gg, Gg, Wot, Wot, Wot, Wot, Wot, Gg, Gg, Gg, Wwf, Gg, Gg, Gg, Re^Vct, Gg, Wwf, Rb, Rb, Rb, Gg, Gg, Gg, Gg, Gg, Wwf, Wwf, Gg, Wwf, Wwf, Wwf, Gg, Gg, Gg, Rb, Wwf, Rb, Wwf, Wwf, Gg, Gg, Gg, Gg, Gg, Gg, Xue, Xue
Gg, Xue, Gg, Gg, Gg, Gg,1 Re^Vct, Gg, Gg, Gg, Gg, Gg, Gg, Gg, Gg, Gg, Wot, Wot, Wot, Wot, Wot, Wot, Wot, Wot, Wot, Wwf, Gg, Gg, Gg, Gg, Gg, Gg, Wwf, Rb, Rb, Rb, Gg, Gg, Gg, Gg, Gg, Gg, Gg, Wwf, Gg, Gg, Gg, Wwf, Gg, Gg, Rb, Rb, Rb, Rb, Rb, Wwf, Wwf, Gg, Gg, Gg, Wot, Wot, Wot
Gg, Gg^Xo, Gg, Gg, Gg, Gg, Gg, Gg, Gg, Gg, Gg, Gg, Gg, Gg, Wot, Wot, Wot, Wot, Wot, Wot, Wot, Wot, Wot, Wot, Wot, Wot, Wot, Gg, Gg, Gg, Gg, Gg, Wwf, Rb, Gg, Gg, Gg, Gg, Gg, Gg, Re^Vct, Gg, Gg, Wwf, Gg, Gg, Gg, Wwf, Wwf, Gg, Gg, Rb, Rb, Rb, Gg, Gg, Gg, Wwf, Wot, Wot, Wot, Wot, Wot
Gg, Gg^Xo, Gg, Gg, Gg, Gg, Gg, Gg, Gg, Gg, Gg, Gg, Wot, Wot, Wot, Wot, Wot, Wot, Wot, Wot, Wot, Wot, Wot, Wot, Wot, Wot, Wot, Wot, Gg, Gg, Gg, Gg, Wwf, Gg, Gg, Gg, Gg, Gg, Rb, Rb, Rb, Gg, Gg, Wwf, Wwf, Gg, Gg, Gg, Wwf, Gg, Gg, Gg, Gg, Gg, Gg, Gg, Wot, Wot, Wot, Wot, Wot, Wot, Wot
Gg, Xue, Gg, Gg, Gg, Gg, Gg, Gg, Gg, Gg, Wot, Wot, Wot, Wot, Wot, Wot, Wot, Wot, Wot, Wot, Wot, Wot, Wot, Wot, Wot, Wot, Wot, Wot, Wot, Gg, Gg, Gg, Wwf, Gg, Gg, Gg, Gg, Gg, Rb, Rb, Rb, Gg, Gg, Gg, Wwf, Gg, Gg, Gg, Gg, Wwf, Wwf, Gg, Gg, Gg, Wot, Wot, Wot, Wot, Wot, Wot, Wot, Wot, Wot
Gg, Gg^Xo, Gg, Gg, Gg, Gg, Gg, Gg, Wot, Wot, Wot, Wot, Wot, Wot, Wot, Wot, Wot, Wot, Wot, Wot, Wot, Wot, Wot, Wot, Wot, Wot, Wot, Wot, Wot, Wot, Wot, Gg, Wwf, Gg, Gg, Gg, Gg, Gg, Gg, Rb, Rb, Gg, Gg, Gg, Wwf, Gg, Gg, Gg, Gg, Gg, Gg, Wwf, Wot, Wot, Wot, Wot, Wot, Wot, Wot, Wot, Wot, Wot, Wot
Gg, Xue, Gg, Gg, Wot, Gg, Wot, Wot, Wot, Wot, Wot, Wot, Wot, Wot, Wot, Wot, Wot, Wot, Wot, Wot, Wot, Wot, Wot, Wot, Wot, Wot, Wot, Wot, Wot, Wot, Wot, Wot, Wot, Gg, Gg, Gg, Gg, Gg, Gg, Gg, Rb, Gg, Gg, Gg, Wwf, Gg, Gg, Gg, Gg, Gg, Wot, Wot, Wot, Wot, Wot, Wot, Wot, Wot, Wot, Wot, Wot, Wot, Wot
Gg, Gg^Xo, Wot, Wot, Wot, Wot, Wot, Wot, Wot, Wot, Wot, Wot, Wot, Wot, Wot, Wot, Wot, Wot, Wot, Wot, Wot, Wot, Wot, Wot, Wot, Wot, Wot, Wot, Wot, Wot, Wot, Wot, Wot, Gg, Wot, Gg, Gg, Gg, Gg, Gg, Gg, Gg, Gg, Gg, Wwf, Gg, Wot, Gg, Wot, Wot, Wot, Wot, Wot, Wot, Wot, Wot, Wot, Wot, Wot, Wot, Wot, Wot, Wot
Wot, Wot, Wot, Wot, Wot, Wot, Wot, Wot, Wot, Wot, Wot, Wot, Wot, Wot, Wot, Wot, Wot, Wot, Wot, Wot, Wot, Wot, Wot, Wot, Wot, Wot, Wot, Wot, Wot, Wot, Wot, Wot, Wot, Wot, Wot, Wot, Wot, Gg, Gg, Gg, Gg, Gg, Gg, Gg, Wot, Wot, Wot, Wot, Wot, Wot, Wot, Wot, Wot, Wot, Wot, Wot, Wot, Wot, Wot, Wot, Wot, Wot, Wot
Wot, Wot, Wot, Wot, Wot, Wot, Wot, Wot, Wot, Wot, Wot, Wot, Wot, Wot, Wot, Wot, Wot, Wot, Wot, Wot, Wot, Wot, Wot, Wot, Wot, Wot, Wot, Wot, Wot, Wot, Wot, Wot, Wot, Wot, Wot, Wot, Wot, Wot, Wot, Wot, Wot, Wot, Wot, Wot, Wot, Wot, Wot, Wot, Wot, Wot, Wot, Wot, Wot, Wot, Wot, Wot, Wot, Wot, Wot, Wot, Wot, Wot, Wot
Wot, Wot, Wot, Wot, Wot, Wot, Wot, Wot, Wot, Wot, Wot, Wot, Wot, Wot, Wot, Wot, Wot, Wot, Wot, Wot, Wot, Wot, Wot, Wot, Wot, Wot, Wot, Wot, Wot, Wot, Wot, Wot, Wot, Wot, Wot, Wot, Wot, Wot, Wot, Wot, Wot, Wot, Wot, Wot, Wot, Wot, Wot, Wot, Wot, Wot, Wot, Wot, Wot, Wot, Wot, Wot, Wot, Wot, Wot, Wot, Wot, Wot, Wot
Wot, Wot, Wot, Wot, Wot, Wot, Wot, Wot, Wot, Wot, Wot, Wot, Wot, Wot, Wot, Wot, Wot, Wot, Wot, Wot, Wot, Wot, Wot, Wot, Wot, Wot, Wot, Wot, Wot, Wot, Wot, Wot, Wot, Wot, Wot, Wot, Wot, Wot, Wot, Wot, Wot, Wot, Wot, Wot, Wot, Wot, Wot, Wot, Wot, Wot, Wot, Wot, Wot, Wot, Wot, Wot, Wot, Wot, Wot, Wot, Wot, Wot, Wot
Wot, Wot, Wot, Wot, Wot, Wot, Wot, Wot, Wot, Wot, Wot, Wot, Wot, Wot, Wot, Wot, Wot, Wot, Wot, Wot, Wot, Wot, Wot, Wot, Wot, Wot, Wot, Wot, Wot, Wot, Wot, Wot, Wot, Wot, Wot, Wot, Wot, Wot, Wot, Wot, Wot, Wot, Wot, Wot, Wot, Wot, Wot, Wot, Wot, Wot, Wot, Wot, Wot, Wot, Wot, Wot, Wot, Wot, Wot, Wot, Wot, Wot, Wot
Wot, Wot, Wot, Wot, Wot, Wot, Wot, Wot, Wot, Wot, Wot, Wot, Wot, Wot, Wot, Wot, Wot, Wot, Wot, Wot, Wot, Wot, Wot, Wot, Wot, Wot, Wot, Wot, Wot, Wot, Wot, Wot, Wot, Wot, Wot, Wot, Wot, Wot, Wot, Wot, Wot, Wot, Wot, Wot, Wot, Wot, Wot, Wot, Wot, Wot, Wot, Wot, Wot, Wot, Wot, Wot, Wot, Wot, Wot, Wot, Wot, Wot, Wot
Wot, Wot, Wot, Wot, Wot, Wot, Wot, Wot, Wot, Wot, Wot, Wot, Wot, Wot, Wot, Wot, Wot, Wot, Wot, Wot, Wot, Wot, Wot, Wot, Wot, Wot, Wot, Wot, Wot, Wot, Wot, Wot, Wot, Wot, Wot, Wot, Wot, Wot, Wot, Wot, Wot, Wot, Wot, Wot, Wot, Wot, Wot, Wot, Wot, Wot, Wot, Wot, Wot, Wot, Wot, Wot, Wot, Wot, Wot, Wot, Wot, Wot, Wot
Wot, Wot, Wot, Wot, Wot, Wot, Wot, Wot, Wot, Wot, Wot, Wot, Wot, Wot, Wot, Wot, Wot, Wot, Wot, Wot, Wot, Wot, Wot, Wot, Wot, Wot, Wot, Wot, Wot, Wot, Wot, Wot, Wot, Wot, Wot, Wot, Wot, Wot, Wot, Wot, Wot, Wot, Wot, Wot, Wot, Wot, Wot, Wot, Wot, Wot, Wot, Wot, Wot, Wot, Wot, Wot, Wot, Wot, Wot, Wot, Wot, Wot, Wot
Wot, Wot, Wot, Wot, Wot, Wot, Wot, Wot, Wot, Wot, Wot, Wot, Wot, Wot, Wot, Wot, Wot, Wot, Wot, Wot, Wot, Wot, Wot, Wot, Wot, Wot, Wot, Wot, Wot, Wot, Wot, Wot, Wot, Wot, Wot, Wot, Wot, Wot, Wot, Wot, Wot, Wot, Wot, Wot, Wot, Wot, Wot, Wot, Wot, Wot, Wot, Wot, Wot, Wot, Wot, Wot, Wot, Wot, Wot, Wot, Wot, Wot, Wot
Wot, Wot, Wot, Wot, Wot, Wot, Wot, Wot, Wot, Wot, Wot, Wot, Wot, Wot, Wot, Wot, Wot, Wot, Wot, Wot, Wot, Wot, Wot, Wot, Wot, Wot, Wot, Wot, Wot, Wot, Wot, Wot, Wot, Wot, Wot, Wot, Wot, Wot, Wot, Wot, Wot, Wot, Wot, Wot, Wot, Wot, Wot, Wot, Wot, Wot, Wot, Wot, Wot, Wot, Wot, Wot, Wot, Wot, Wot, Wot, Wot, Wot, Wot
Wot, Wot, Wot, Wot, Wot, Wot, Wot, Wot, Wot, Wot, Wot, Wot, Wot, Wot, Wot, Wot, Wot, Wot, Wot, Wot, Wot, Wot, Wot, Wot, Wot, Wot, Wot, Wot, Wot, Wot, Wot, Wot, Wot, Wot, Wot, Wot, Wot, Wot, Wot, Wot, Wot, Wot, Wot, Wot, Wot, Wot, Wot, Wot, Wot, Wot, Wot, Wot, Wot, Wot, Wot, Wot, Wot, Wot, Wot, Wot, Wot, Wot, Wot
